16
10
###############-
#$##*##$##*##$#-
###############-
----------------
-###*###*###*##-
-#*###*###*####-
----%-----%-----
-###############
-#*##*##*##*##*#
-###############
